############
#          #
#          #
#          #
#    @     #
#          #
#          #
#####_######
